********    S0000000
****X***    ####6###
2***.***    30000000
3*******    30000000
********    00000000
********    00000000
********    00000000
********    00000000
Round 7
Player at 0,0


********    S0000000
****#***    ####6###
****c***    30000000
3*******    30000000
********    00000000
********    00000000
********    00000000
********    00000000
Removables: 25
Round: 7
Player at 0,0
